................
0...............
##..............
####............
.....####.......
........../#....
........#####.##
.....##.........
....#####./../.0